# 1
[
    [1,1,1,1,1,1,1,1,1,1,1,1],
    [1,0,0,0,0,0,0,0,0,0,0,1],
    [1,0,2,0,0,0,0,0,3,0,0,1],
    [1,0,0,0,0,0,0,0,0,0,0,1],
    [1,1,0,1,1,0,0,1,1,0,0,1],
    [1,3,0,0,0,0,0,0,0,3,0,1],
    [1,0,2,0,0,0,0,2,0,0,0,1],
    [1,0,0,0,1,5,1,0,0,0,0,1],
    [1,1,1,1,1,1,1,1,1,1,1,1]
]
#2
[
    [1,1,1,1,1,1,1,1],
    [1,0,0,2,0,3,5,1],
    [1,0,2,0,0,1,3,1],
    [1,3,3,2,0,2,2,1],
    [1,3,3,2,0,0,0,1],
    [1,1,1,1,1,1,1,1]
]
#3
[
    [0,0,0,1,1,1,1,1,1,1,1],
    [0,0,0,1,0,0,0,0,0,0,1],
    [0,0,1,1,0,0,0,0,2,0,1],
    [0,1,0,0,0,1,1,0,1,1,1],
    [1,1,0,0,1,0,0,3,0,0,1],
    [1,0,0,1,3,2,2,0,0,1,1],
    [1,5,1,3,0,0,0,0,1,1,0],
    [1,1,0,0,0,0,0,1,1,0,0],
    [1,1,1,1,1,1,1,1,0,0,0]
]
#4
[
    [1,1,1,1,1,1,1],
    [1,5,0,2,0,3,1],
    [1,1,0,2,0,1,1],
    [1,3,0,0,0,0,1],
    [1,1,1,1,1,1,1]
]
#5
[
    [1,1,1,1,1,1],
    [1,5,2,3,1,1],
    [1,2,2,1,1,1],
    [1,0,3,0,0,1],
    [1,0,0,0,0,1],
    [1,3,3,2,0,1],
    [1,1,1,1,1,1]
]

# Default map in examples
[
    [1,1,1,1,1,1,1],
    [1,5,0,2,0,3,1],
    [1,0,0,0,0,0,1],
    [1,0,0,2,0,3,1],
    [1,0,0,0,0,0,1],
    [1,1,1,1,1,1,1]
]



